Level 1
100 5
111111111111
100000000001
203000003001
100330003001
100030100001
100000100001
111111111111
;abc 12;def 7;ghi 8;;;
