100 5
111111111111111111111111111111111111111111111
100000000000000060000000000000060000000006001
100005060500000056000050600055060005006000001
100111111111111111111111111111111111111111001
106122222202232502222252522253222525222221001
100125852022222222222222220535222222252221601
160122222222222360000322222252222002205251001
100152552522222222222222252222222202202521001
106152052522600006220225232322222222222221601
100122202522222222222222552222222222522251001
100111111111111111111111111111111115222221601
100000000600000000000000006000005500000001001
160006000505000000550060000500055550000001001
100111111111111111111111111111111115222221601
160122222222226000222223222252222522232221001
100155020522220225222222255252052220602221601
106152222552522222223255252255222522222521001
100122022522352055555522220222222022522221061
160432222202522220225222222325555225522251601
100150222006522233322000222222233222322551001
106111111111111111111111111111111111111111001
100606000000060000006000006000000000600000061
100600005600060000060050006000000005000000001
111111111111111111111111111111111111111111111
;def 155;you 153;;;;
