Level 1
100 5
11111111111111
15555555000501
10000000000001
40070050800001
10600222200001
10000000000001
11111111111111
;abc 12;def 7;ghi 8;;;
