60 8
11111111111111111111111111111111
17255555555555522000000000000001
10115555555552220000000000000001
11111555555522000000000000000001
11111155555222000000000000000001
11111115552222000000000000000001
12222222522222000000000000000001
12222222222222000000000000000001
12222222000508000000000000000001
11111111011111000000000000000001
10000003030000000000000000000004
11111111111111111111111111111111
;you 253;asdas 228;ghgh 205;sdf 202;ghh 201;
