Level 1
100 5
11111111111111
10000000000081
10505050500051
40000000000001
10000000000001
10000000000001
15050505050551
10000000000001
10000000000001
10000000000001
10707070707001
10000000000001
10000000000001
17070707070701
11111111111111
;abc 12;def 7;ghi 8;;;
