Level 1
100 5
11111111111111111111111111111
10000000000000000000003000001
20300000300000000003000003001
10033000300300000000300000001
10003010000800000000000003001
10000010000000000000000300001
10033000300300000000300000001
10033000000300000000000000001
10033000300300000000300000001
10033000300300000000000000001
10033000000300000300300000001
10033000300300000000000000001
10033000300000000000300000001
10033000300300030000000000001
10033000000300000000300000001
10033000000300000000300000001
10033000300300000000000000001
10033000300300000000300000001
11111111111111111111111111111
;abc 12;def 7;ghi 8;;;
