320 20
111111111114111111111111
100000000000000000000001
101010101010101010101101
108235222325222222223001
101252352553525552553101
100235352252252225222001
101252335235352522553101
100225535252222252323001
101522352253325332525101
100532525235555525522001
101553253553232222252101
100522222222525352522001
101332555523235522525101
100352322225222252533001
101355552522555325253101
100322255353225222222001
101255222225522252525101
100222555525235352353001
101552252523223223253101
100525232223535252532001
101222552553525523225101
100253232225232252522001
101355552522555225252101
100322255352225253222001
101255322225522252525101
100322552525225332352001
101525222522553255223101
100335352352222225223001
101352225225352522552101
100252222223223252533001
101352552522555235253101
100222325352225352223001
101010101010101010101101
100000000000000000000001
111111111111111111111111
;;;;;;
