Level 1
100 5
11111111111111
10500000500001
12022220050031
42020200800001
12622222500001
12020000000001
12022000000001
12020000000001
12022000000001
12020000000001
12022000000001
12020000000001
12022000000001
12020000000001
12022000000001
11111111111111
;abc 12;def 7;ghi 8;;;
