Level 1
100 5
11111111111111
10000000000081
10000000000001
40000000000001
10000000000001
10000000000001
15555555555551
15555555555551
10000000000001
10000000000001
10000000000001
10000000000001
10000000000001
16666666666661
11111111111111
;abc 12;def 7;ghi 8;;;
