240 20
11111111111111111111111111111111111
11111111111225252525252255552555531
15555555112223232222222222222222221
15555551008020202020202220022555531
15555511222220202020202220022222221
15555112222226162620102220022555531
15551100522220102016162220022222221
15511202222110201110202226022555531
15512272222210205551111226022233331
13322270522221222555552225522200001
10011202222022200525552225522200001
10001102005005202233332223322200001
10002102022222202555555220012200001
10000211622222272111111220012200001
10002221011111111111111117012200001
17070222113003030300000016012266061
17770022210000011111111310012200001
17770022210303011113333011111260661
10001112210300303000000000001111111
10001111011003060030303030300111111
10001111011300030006000700030000411
10001111011111110030303030300111111
10001111000000030000000000001111111
11111111111111111111111111111111111
;szymon 766;;;;;
