Level 1
100 5
11111111111111
10000000000001
10030220050031
40030200800001
10030222200001
10000000000001
11111111111111
;abc 12;def 7;ghi 8;;;
