120 12
1111111111111111111111111111111111111
1000000000000000000000000000000000001
1060602220606062606060602220600060021
1000000000000000000000000000000000001
1000000002220000000000000000000000001
1606060005000000000550000050060606061
1000001111111111111111111111111000001
1002001555555555555555555555551050001
1020201222222222222222222222221022201
1002001005252525225252500222221000201
1002021022222222222222220222551000201
1002001022222222222222220255521000221
1000001025252022220252520252221000001
1000001022222028520222220222021020001
1002201020202022220202020202021022001
1000001020202022220202020202021020021
1002201020202022220202020202021000001
1000001020202022220202020262001000001
1000001020202022220202020202021000001
1000001716161722227161617202001000001
1000001323132312213231323232321000001
1000001323132312213231323232321000001
1000001111111111011111111111111000001
1000000000000002020000000000000000001
1000000000000002020000000000000000001
1000000000000002320000000000000000001
1000000000000002320000000000000000001
1656565656565602020656060606565506061
1111111111111111411111111111111111111
;you 259;;;;;
