100 5
11111111111111111111111111111
10000055050050005005003000001
42305000300000000003000053001
10220000300300500000306000001
10003000005000005005050053001
10200000000050000005000300001
10022080300200000005200000001
10222000000200000005000000001
10022000200200000005200007001
10222000200200600005000000001
10022000000200000300200000001
10222000200200000000000007001
10022000200000000600200000001
10222000200200030000000000001
10200010000050000005000300001
10022000300200000005200000001
10222000000200000005000000001
10022000200200000005200007001
10222000200200600005000000001
10022000000200000300200000001
10222000200200000000000007001
10022000200000000600200000001
10222000200200030000000000001
10022000200200000000000000001
11111111111111111111111111111
;abc 1232;def 732;ghi 8;;;
