Level 1
100 5
11111111111111
10000000000001
10000000000001
40000050008001
10000222000001
10000000000001
11111111111111
;abc 12;def 7;ghi 8;;;
