Level 1
100 5
11111111111111111111111111111
10000005050050005005003000001
40305080300000000003000053001
10022250300300500000306000001
10003010005000005005050053001
10000010000050000005000300001
10022000300200000005200000001
10022000000200000005000000001
10022000200200000005200007001
10022000200200600005000000001
10022000000200000300200000001
10022000200200000000000007001
10022000200000000600200000001
10022000200200030000000000001
10022060000200000000200000001
10022000000200000000200600001
10022000200200000000000000001
10022000200200000000300000001
11111111111111111111111111111
;abc 12;def 7;ghi 8;;;
