Level 1
100 5
11111111111111111111
10000000000000000001
20300000300000000001
10033000300300000001
10003010000800000001
10000010000000000001
11111111111111111111
;abc 12;def 7;ghi 8;;;
