Level 1
100 5
11111111111111
10022222000081
10555000000001
40000002000001
12272002000001
10000000000001
10000000000501
12222222222221
10555555000001
10000000000001
10000000033001
10000000000001
10006000000001
10000030003001
11111111111111
;abc 12;def 7;ghi 8;;;
