80 12
11111111111111111111111111111111111111111111111
11111111111111111111111111111111111111111111111
11111111111111111111111111111111111111111111111
11111111111111111111111111111111111111111111111
11111111111111111111111111111111111111111111111
11255225555222222225555555522222222222222222211
11222225552220003222233222222252222000230222211
11200222223322325250000000222222220030220022211
11280335000252202222000000222202207030330002241
11200222200022202252000000222200222030000002211
11222525000200062255000000222202222000030005511
11111111101111111111100001111262111111111111111
11111111000111111111110611111121111111111111111
11111111000111111111111111111111111111111111111
11111111070111111111111111111111111111111111111
11111111111111111111111111111111111111111111111
;you 253;asdas 228;ghgh 205;sdf 202;ghh 201;
