Level 1
100 5
11111111111111111111111111111
10000000000000000000003000001
40300080300000000003000003001
10022000300300000000306000001
10003010006000000000000003001
10000010000000000000000300001
10022000300200000000200000001
10022000000200000000000000001
10022000200200000000200007001
10022000200200600000000000001
10022000000200000300200000001
10022000200200000000000007001
10022000200000000600200000001
10022000200200030000000000001
10022060000200000000200000001
10022000000200000000200600001
10022000200200000000000000001
10022000200200000000300000001
11111111111111111111111111111
;abc 12;def 7;ghi 8;;;
